//first line for _____ information
//second line for ____ information
//third line for _____ information
------------------
----WWWW-------M--
----WWWW-------M--
----WWWW---X---M--
---------------M--
------------------
-WWWWWWWWWWWWWW---
MWWWWWWWWWWWWWW---
M-----------------