//first line for _____ information
//second line for ____ information
//third line for _____ information
MMMMMMMMMMMMMMMMMMMM
M WWWWWWWW         M
M   WWWWWW         M
M X  WWWWW         M
M      WWWW        M
M V                M
M          WWWW    M
M            WWWW  M
M              WWWWM
M                  M
MMMMMMMMMMMMMMMMMMMM