|--------------------------------|
|~~~~~                           |
|~~~~~        XXXXX              |
|~~~~        XXXXXXX             |
|~           XXXXXXX             |
|             XXXXX              |
|                                |
|         ~~~~~~~~~~~~~~         |
|  ~~~~~~~~~~~~~~~~~~~~~~~~~~~~  |
|--------------------------------|